{
    "Scène" : true,
    "Carte" : [
        ["#","#","#","#","#","#","0","0","0","#","#","#","#","#","#"],
        ["0","0","0","0","0","0","0","0","0","0","0","0","0","0","0"],
        ["0","0","0","0","0","0","0","0","0","0","0","0","0","0","0"],
        ["0","0","0","0","0","0","0","0","0","0","0","0","0","0","0"],
        ["0","0","0","0","0","0","0","0","0","0","0","0","0","0","0"],
        ["0","0","0","0","0","0","0","0","0","0","0","0","0","0","0"],
        ["0","0","0","0","0","0","~","~","0","0","0","0","0","0","0"],
        ["0","0","0","~","~","~","~","~","0","0","0","0","0","0","0"],
        ["0","0","0","~","0","0","0","0","0","0","0","0","0","0","0"],
        ["0","0","0","~","0","0","0","0","0","0","0","0","0","0","0"],
        ["~","~","~","~","0","0","0","0","0","0","0","0","0","0","0"],
        ["0","0","0","0","0","0","0","0","0","0","0","0","0","0","0"],
        ["0","0","0","0","0","0","0","0","0","0","0","0","0","0","0"],
        ["0","0","0","0","0","0","0","0","0","0","0","0","0","0","0"],
        ["0","0","0","0","0","0","0","0","0","0","0","0","0","0","0"]
    ],
    "Entités":[
        {
            "ID" : "Guildart",
            "Position" : [7,0]
        }
    ],
    "Joueur_pos" : [7,1],
    "Séquence" : [
        {
            "Dialogue Groupe":"Intro",
            "Dialogue ID" : [0]
        }
    ],
    "Prochaine" : "Chapitre1"
}